A     #
##### #
#   # #
# # # #
# #   #
# ###B#
